  #############
  ##..  #     ####
  ##..  # $  $  ##
  ##..  #$####  ##
  ##..    @ ##  ##
  ##..  # #  $ ###
  ####### ##$ $ ## 
    ## $  $ $ $ ##
    ##    #     ##
    ##############